001020020000000000
021000000020020020
001111111102000000
020000000120011111
001111111100212000
021000000000010000
001020211111110200
021000012020202000
001111110000000000
000000000000000000