001000000000000000,
001000000002000000,
001111111100000000,
020000000102011111,
001111111100010000,
001000000000010200,
001020011111110000,
001000010000000000,
001111110200000000,
000000000000000000,